########################################################
########################################################
########################################################
########################################################
########################################################
########################################.......#########
########################################...K...#########
########################################.......#########
###########################################.############
###########################################.############
##################.............############.############
##################......B...................############
##################.............#######.#################
######################################.#################
######################################.#################
######################################.#################
######################################........##########
#############################################.##########
#############################################.##########
#############################################.##########
#############################################.##########
########################################################
########################################################
########################################################
########################################################
########################################################
########################################################
########################################################